* *************************************************
*     *   *       *   *     * *   *     *   *     *
* ***** * * ***** * * * *** * * * * *** * *** *** *
*       *   *   *   * * *   *   * * *   *     * * *
*************** ***** * ********* * * ********* * *
* *   *               *   *       * *   *   *   * *
* * * ******* * ********* * *** * * * *** * * *** *
*   * *   * * * *     *   *   * * * *     * *   * *
***** * * * * * * *** * ***** *** * ***** * * * * *
* *   * *   * * * * * *       *   * * *   *   * * *
* * ******* * * * * * ******* * *** * * * ***** * *
* *     * * * *   *     *   * * *   *   * *   * * *
* ***** * * * ********* *** *** ***** ***** * * * *
* *   *   *       *     *   *       * *     * *   *
* * *** * *** ***** *** * * * ***** * * ***** * ***
* *   * * *       *   * * * *   *   * * *     *   *
* * * * * * ***** *** * * * *** * ***** * ******* *
*   * * *   *   * *   * * * *   * *     *     *   *
***** * ***** * * * ***** * * *** * ********* * ***
*   * * *     *   *   *   * *   * * * *     * *   *
* *** * * *********** * *** ***** * * * ***** *** *
* *   * *       *   * *   *       * *             *
* * ******* ***** * * *** ********* ********* *** *
* *         *     *     *       *   *       * *   *
* *********** * ******* ***** *** *** *** * * *****
* *         * * *       *   *   * * * * * * * *   *
* * ******* *** *** ***** * *** * * * * * *** * * *
* *       *       * *   * *     * *   * *     * * *
* *************** * * * * *** *** ***** * ***** * *
*         * *     *   *   * * *   *     * *     * *
********* * * ******* * *** * * *** ***** *** *** *
*   *   *     *       *   * *   *   *   *   * *   *
* * *** ***** * *** *** * * ***** *** ***** * * ***
* *         * * *   *   * * *   *   *       * *   *
* ********* *** * ******* * * * *** ********* * * *
*     *   *     *     *   * * *   *       *   * * *
*** * *** *********** * *** * ******* *** * *** * *
*   * *   *   *   * * *   *     *       * * *   * *
* *** * *** * * * * * ******* * * ******* * * *** *
* *   * *   *   * *       *   * * *     *   * *   *
*** *** ********* * * *** ***** * * *** ***** * ***
*   *   *   *   * * *   *     *   * *   *   * *   *
* *** *** * *** * * *** ***** * *** * ***** * *** *
* *     * *   * * * *   *   *   * * * *   * *   * *
* * ***** *** * * * * ***** ***** * * * * * * * * *
*     *   * * * * * *       *       *   *     * * *
*** * * *** * * * * ********* ************* *** ***
* * * * *     * * * *       *       *   * *   *   *
* * * * * ***** * * * * *** ******* *** * *** *** *
*   *   *         *   *   *       *     *     *   E
***************************************************